NO  ./img/XPM/walls/W_WH_NO.xpm
SO  ./img/XPM/walls/W_WH_SO.xpm
WE  ./img/XPM/walls/W_WH_WE.xpm
EA  ./img/XPM/walls/W_WH_EA.xpm

F   139,0,0
C   235,228,228

1111111
1010001
1000101
1S11101
1000101
1010101
1010001
1010101
1000101
1011101
1010001
1010101
1010001
1111111
