NO  ./img/XPM/walls/W_WH_NO.xpm
SO  ./img/XPM/walls/W_WH_SO.xpm
WE  ./img/XPM/walls/W_WH_WE.xpm
EA  ./img/XPM/walls/W_WH_EA.xpm

PNS  ./img/XPM/doors/DO_destruct_N_S-01.xpm
PWE  ./img/XPM/doors/DO_destruct_W_E-01.xpm
ELE  ./img/XPM/doors/ELE.xpm

B ./img/XPM/doors/DO_BearS.xpm
X ./img/XPM/doors/DO_237_01.xpm

T ./img/XPM/characters/C_Twins_01.xpm
D ./img/XPM/characters/DAN_01.xpm

F ./img/XPM/floor/FL_RedCarpet.xpm
C           ./img/XPM/ceiling/C_WH.xpm



          111111111111111
          111P1P1P1P1P111
          100000000000001
    111   101P1P1P1P1P101
    101   101110111011101       
11111P11111P10111111101P1111111111111111111111111111
1100101P1P101P1P101P1P101P1P101101P1P1P1011P1P1P1011
1A000000000000000000000000000W1000000000T000000000A1
1100101P1P101P1P101P1P101P1P101101P1P1P1011P1P1P1011
11111P11111111111P111111111111110111111P0P1111111111
    101000000000000000111      101    11011
    1111P11111P11111P1111111111101    1P0P111111111111111111111
      1111110000001101P1P1P1P1P1P111  110111P11P11P11P11P111111
      1B00P00000000000000D0000000001  10000000000000000000000X1
      1111110000001101P1P1P1P1P10111  110111P11P11P11P11P111111
           1111111111101110111011111  1P0P111111111111111111111
                     111 111 111      11011
                                      1P0P1
                                      11011
                                      10001
                                      11111
