NO  ./img/XPM/walls/W_WH_NO.xpm
SO  ./img/XPM/walls/Cacahuetes.xpm
WE  ./img/XPM/walls/W_WH_WE.xpm
EA  ./img/XPM/walls/W_WH_EA.xpm

F   5  5,   5  0,5  0 
C   18    , 18,    18

111111
100001
100N01
111111
