NO  ./img/XPM/walls/W_WH_NO.xpm
SO  ./img/XPM/walls/W_WH_SO.xpm
WE  ./img/XPM/walls/W_WH_WE.xpm
EA  ./img/XPM/walls/W_WH_EA.xpm

F   55,50,50
C   18,18,18

11111111
100z00N1
11111111
